999999999999999999999999999999999999999999999999999999999999999999999999999999999999999999999999999
900000000000000000000000000000000000000000000000000000000000000000000000000000000000000000000000009
900999999099999990999999999099999999999990999999909999909990999999909999999999909999999999999999909
900000009090000090009000909090000000000090900000909000900090900090900090009000900090009000000000909
909999909990999099909990909099909990999990999990999090999099909990999099909099999090999099999990909
900000900000009000900090909000909090900000009090000090009000009000009000009000009000900090000090909
909990999999909990909990909990999090999999909090999999909999909990999990999099909990999999999090909
909090009000909090900000900090009090000000900090900000000000909090000090909090900090900000000090909
909099909990909090999990999099909099909990999990909990999990909099909099909090999090909999999990909
909000900090909000000090009000900000909090000000909090909000909000909000900090009090909000000000909
909099999990999099999099999090999999909099999999999099909099909099909999909990909090909099999999909
909000000000000090009000000090000000009000000000000000009090000090009000009000909090909000900000009
909999999099999990999099999999999999909990999999999099909990999990999099909999909090909990999999909
909000009090000000909090000000000090900090900090009090900000900000900090900000909090000090000000909
909099999090999099909090999999999090909090999090999990909999909999909990999999909099999099909990909
909090009090009090009090900000009090909090000090000000909000000000009000000000909000009090900090909
909090909099999090909090909990999090909090999099909990909099999999999099999990909090999090909990909
909090909000009090909000900090900090909090909000909090909090000000000090000090009090900000909090909
909090999990999090909999909990909990999090909999909099909990999990999990999090999099909999909090909
909090000000900090900000009090909090009090900000009000000090900090900000009090900090009090009000909
909090999999909990999099999090909099909099909999909999999099909990909999999099909990999090999099909
909090900000009000009090900090900090900000000090900000009000000000909000009000009000000090909090009
909099999099909099909990999090999090999099999990909999909999999999909099999099909099999990909090909
900000009090909090900000009000009090009090009000909000900000000000009000900090909090000000909090909
909990909090999090999999909990999090999090909990909990909999999099909990999090909990999099909099909
909090909090000090900000900090900000900090900090900090909000009090909090009000900000900090900000909
909090999099909990909990999990999990999099999090999990909990999090909099909099909999909990909999909
909090009000909000909090000090000090009090000090000000900090900090909000909090909000909000909000009
909099909090909990909099909090999099909990999090999990999090999090999090909090909990999090999099909
909000909090909090009000909090009000900000909090900090009090000090000090909090000090000090000090909
909099909990909099999990909099999990999999909990909099909099999990999990909099999090999099999090909
909090000000909000000000909000000090000000000000909000909090000000000090909090009090909090009090909
909099999099909990999999909990999099909999999099999099909099909999999990909099909099909990999090909
909000009090000000900000009000909000909000009090000090909000900000900090909090009000000000900000909
909099909990999999909999909099909999909999909090909990909090999999909090909090999999909990909990909
909090900000009090009000909090000000000000909090909000009090000000009090909000900090009090909090909
909090999999909090999099909999999990999990909990909990999099999990999990909099909990999099909099909
909000900000909090900090000000000000900090900000900090900090000090900000909090000090900000009000009
909990999990999090999090999999999990909990999990909990909990999090909990909990999090999990999999909
909090000090000000009090900000000090909000000090909000909090909090909000909000909000000090000000909
909099999099909990999090909999999099909999999090909099909099909090999099909099909999999099999990909
900000009090909090900090900000009000000090900090909090009000009000009090000090000090009000000090909
909999999090909099999090999099909099999090999099909990909090999099909099909990999990999990999099909
909000000000909000000090009090909090009000909000900000909090900090909000909000900000009000909000909
909099999999909990999999909990999090909990909990909990999990909990999090999990999999909099909099909
909000900000009000909000000000900090900090000090900090900000909000000090000000000000900090009090009
909990999999909099909099999990909990999990999090999099909990999099999999999099999999909990999090909
909090900000909090000090000090909000900000909090009000009090900090000000000090000000909000900090909
909090999990999090999990999099909990999999909990909099999090909990999099999090999099909990999099909
909090000000009090900000909000000090000000000090909090000090909090909090009090909090000090009000909
909099999999909090909990909999999099999099999999909090999090999090909990999090909999999090909999909
909000000000900090909090009000009000009000000000009090909090000000900000900090900000009090900000009
909999999099909990909099909999909099909999909999909990909090999099909099909990999099909099999999909
900000900090009090909000900000909090900000909000900000909090909090009090009000000090900000000000909
909099909990999090999090909999909990999090999099999990909099909099909999909999999990999990999099909
909090009000900000000090900000900000909090000090000090909000009000900000909000000000009000909090009
909999909090999990999099909990999090909999909099909099909999909990999099909990999999999099909090909
909000009090900090909090009090009090900000909000909090000000900090909000900000900000900090009090909
909099999090909099909090999090999990909990909099909990999990909990909990999990999990909990999099909
909090000090909000009090900090000000909000909090000000900090009000900090000090000090909000900000909
909099909990909099999099909999999999909999909090999990909099999090909090999099999990909990909990909
909000909000909090000000009000000000009000009090900090909000000090909090909000000090000090909090909
909099909999999090999999999099909999909990999099999099999099999990999090909999999990999990909099909
900090900000009090900000000090909000900090909000000000009090009000900090900000000000900000909000009
909990909990999099909999909990909099909099909099909990909090909099909990909999999099909990909099909
909000009090900000000000909000909090009000009090009090909090909090009000900000900090009000909090909
909099999090999099999999909990909099909999909099909090909099909999909090909999909990999990999090909
909090000090009090900090009000909000909000909000909090909000900000009090909000009000900090000000909
909990999990909090999090999099909990999099909999909090999099909099999090909999909099999099909999909
909000900000909090009000900090000090000090000090009090900000909090000090909000909000000090909090009
909090999099999090999099999099909990909990999090999090999990999090909999909990909999999990909099909
909090009090000000909090000000909000909000900090900090000090000090909000000000900000000000900000909
909990999090999990909090999999909099999999909990909090999999999990999990999990909999999990999999909
900000900090009090900090900000009000000000009000909090000000000090000090900090909000009090000000909
909999909099999090909990909990999099999999909099909099999999909990999099909990999099909099909999909
909000009000000090909000909090909090000000909090009000000000900000909000009000000090900000909000009
909990999999909990909099909099909999999990999099999990999990999099909999909990999990999999909999909
900090900090009000909090009000000000009000000000000090009090009090000000900090900000000090000000909
909990999099999099909099909099999990909099999999999099909090999090909990999099909990999090999999909
909000009000000090009000900090000090909090000000009000909090909090909090009090009090909000900000009
909099999990999990999090999990999090999099909999999090909090909099909099999090999099909099909999909
909000000090909090900090000000900090900090009000009090900090909000909000000090900000009090009000909
909999999090909090909999999099999090909990999099909990999990909099909099999990999099909990999099909
900000009090009090900090009000909090009000900090900090000090900090009000000000009090900000900000909
909999909099999090909990909990909099999990909990999099909990999990909999909999909090999099909990909
909000909000000090909000900090009000000000909090000000909000000000900000909000909000009090909090009
909099999099999090999099999099909999999099909099999999909999999090999099909990909999909990909099909
909090000000009090000090909000900000909090009000000000000000009090909090000090900000909000909000909
909090999999909090999990909090999999909090999099999990999999909099909099999090909999909090999090909
909000900000909090900000909090009000000090900090009090009000909000009000009090909000009090000090909
909099999990909990999990909999909099999990999090999099999099909990999990999090999099999999999990909
909090000090909000900000909000009090900000009000900000000090000090900090909090000000000000000000909
909990999090909099909999909099909090909999909999909999999999999090909090909099909999909999999999909
909000909000900090009000000090909090009000900000009000000000009090909090900000909090909000000000909
909099909999909990999099999990909090999099909999909099909999909090909990909990909090909090999990909
909090000000009000900090000000909090900090009000900090909000900090909000909090900090909090900090909
909099999999999990999999999990999099999099999990999990999990999999909990999099999990999099999099909
900000000000000000000000000000000000000000000000000000000000000000000000000000000000000000000000009
999999999999999999999999999999999999999999999999999999999999999999999999999999999999999999999999999
