   4 4 4 4 4   4 4 4 4 4   4 4 4 4 4   4 4 4 4 4
   1 0 0 0 0   0 0 0 0 0   0 0 0 0 0   0 0 0 0 3
   1 0 0 0 0   0 0 0 0 0   0 0 0 0 0   0 0 0 0 3
   1 0 0 0 0   0 0 0 0 0   0 0 0 0 0   0 4 0 0 3
   1 0 0 0 0   0 0 0 0 0   0 0 0 0 0   0 0 0 0 3

   1 0 0 0 0   0 0 0 0 0   0 0 0 0 0   0 0 0 0 3
   1 0 0 0 0   2 2 2 2 2   2 2 2 2 2   0 0 0 0 3
   1 0 0 0 0   3 9 9 9 9   9 9 9 9 1   0 0 0 0 3
   1 0 0 0 0   3 9 4 4 4   4 4 4 4 4   0 0 0 0 3

   1 0 0 0 0   3 9 1 0 0   0 0 0 0 0   0 3 0 0 3
   1 0 0 0 0   3 9 1 0 0   0 0 0 0 0   0 0 0 0 3
   1 0 0 0 0   3 9 1 0 0   0 0 0 0 0   0 3 0 0 3
   1 0 0 0 0   3 9 2 2 2   2 2 2 2 2   0 0 0 0 3
   1 0 0 0 0   3 9 9 9 9   9 9 9 9 1   0 0 0 0 3
   1 0 0 0 0   4 4 4 4 4   4 4 4 4 1   0 0 0 0 3
   1 0 0 0 0   0 0 0 0 0   0 0 0 0 0   0 0 0 0 3

   1 0 0 0 0   0 0 0 0 0   0 0 0 0 0   0 2 0 0 3
   1 0 0 0 0   0 0 0 0 0   0 0 0 0 0   0 0 0 0 3
   1 0 0 0 0   0 0 0 0 0   0 0 0 0 0   0 0 0 0 3
   1 0 0 0 0   0 0 0 0 0   0 0 0 0 0   0 0 0 0 3
   2 2 2 2 2   2 2 2 2 2   2 2 2 2 2   2 2 2 2 2
